1111111111111
1001000P000C1
10E0011111001
100011P000001
1111111111111