11111111111111111111111111
10000001000000000000000001
10P000010000000000000C0001
100000010000000E0000000001
10000001000000000000000001
10000001000C00000E00000001
10000001000000000000000001
100C0001000000000001111111
1000000100000000C000000001
11111111111111111111111111