1111111111111
1C01000C000C1
1000011111001
10P011EC00001
1111111111111





