1111111111111
1000000000001
1000010C00001
10P011E000001
1111111111111
