1111111111111
1C00000000001
1110010000001
10P011E000001
1111111111111